66666666666666666666-
00000000000000000000-
00000000000000001000-
00000000000000001000-
00000000000000000000-
00001100000000000000-
50001111000000000000-
00111000000000000000-
00000000000011100000-
00000000000001100000-
00501110000000000000-
00000011100000000000-
00000000000000000000-
00000000000011110000-
11000000000011110000-
01110000000000000000-
01111000000000000000-
00001100000000000000-
00000000010110000000-
50005000000111110050-
00000000000011100000-
00005005000000011000-
00000000000000010000-
00000000010100000000-
00000011110000000000-
11000111110000050000-
00000011110100000000-
00000000000000000000-
00000000000500011110-
00000000000000011110-
11000005000000011110-
00110000000000000000-
00000000000000000000-
00001100000000110000-
00001111000000110000-
00001100110000110000-
00001100001100110000-
00001100000011110000-
00001100000000110000-
00000000000000500000-
00000001111110000000-
00000110000000000000-
00011000000000000000-
00011005000111111000-
00011000000000011000-
00000110000001100000-
00000001111110000000-
11000000000000000000-
11000000000000111110-
00000000550000110000-
00000000550000110000-
00000000550000110000-
00001100000000110000-
00001100000011000000-
00000011111100000000-
00000000000000000000-
00000000000011000000-
11000000000000000000-
00000000000000005000-
00001510000000000000-
00000000000000000000-
00000000000000000000-
00000000000000111111-
00000000000000000000-
11001100000000000000-
00000111000000000000-
00000000000000000000-
01100000000001111100-
51110000000111000000-
51110000000111000000-
51110000000111000000-
51100000000000000000-
51101100000000000000-
51100111000000000000-
51100011000000500000-
01100000000000000000-
00000000000000000110-
00000000011111110000-
00000000011111000500-
00000011101111100500-
11000000000000000000-
00000005000111100000-
00000000000000000000-
00050000000000000000-
00050000000111111111-
00000000111111000000-
00000000000000005500-
00000000011111100000-
00000000000001100000-
00000000110001111100-
00001111000000000000-
00000000000000000000-
11110000000000000000-
00000000000000000000-
00000000000000011000-
00000000000000011000-
00000000111111111110-
00000000000000000000-
00000000000000000000-
77777777777777777777
77777777777777777777
77777777777777777777
77777777777777777777
77777777777777777777
77777777777777777777
77777777777777777777
77777777777777777777
77777777777777777777
77777777777777777777
77777777777777777777